00001111111000011111
11100011111001000111
11110011111001110011
11111011110000111001
11100011110110111101
11000111110110111100
10001111110110111110
00011111110110111110
00111111000110001110
01111111011111101110
01111111000000001110
00001111111001111110
11100000000001111110