01111000000001111111
01111011111001100000
01111011111001101110
01111011110000001110
01100011110110111110
01000111110110111110
01001111110110111110
01011111110110111100
00011111000110001101
11111111011111101101
11111111000000001100
11111111111001111110
11111111111000000000