00000000000000000000
11111110111111011110
00000000000000000000
01111110111111011110
00000000000000000000
11111110111111011110
00000000000000000000
01111110111111011110
00000000000000000000
11000000111111000000
11000000111111000000
11000000000000000000
11111111111111111110
