00111111111111111111
10000000000000000000
10000000000000000000
10011100000000011100
10011100000000011100
10011100000000011100
10000000011100000000
10000000011100000000
10011100000000011100
10011100000000011100
10011100000000011100
10000000000000000000
10000000000000000000
